####################
#S..#......#.......#
#.#.###.#..#..###..#
#.#.....#..#....#..#
#.#######..####.#..#
#.......#.....#.#..#
###.###.#####.#.#..#
#...#.......#.#....#
#.###.#####.#.####.#
#...#...#...#.....G#
#.#.#.#.#.###.###..#
#.#.#.#.#.....#....#
#.#.#.#.#######.##.#
#.....#.............#
####################
