############
#S..#..#.G.#
#.#.#..#..##
###.##.##..#
#....#.#.#.#
#.##...#.#.#
#...#......#
############
