#S..............................................#
#.##############################################.#
#.#............................................#.#
#.#.##########################################.#.#
#.#.#......................................#...#.#
#.#.#.####################################.#.#.#.#
#.#.#.#....................................#.#.#.#
#.#.#.#.##################################.#.#.#.#
#.#.#.#.#................................#.#.#.#.#
#.#.#.#.#.################################.#.#.#.#
#.#.#.#.#.#..............................#.#.#.#.#
#.#.#.#.#.#.############################.#.#.#.#.#
#.#.#.#.#.#.#..........................#.#.#.#.#.#
#.#.#.#.#.#.#.########################.#.#.#.#.#.#
#.#.#.#.#.#.#.#........................#.#.#.#.#.#
#.#.#.#.#.#.#.#.######################.#.#.#.#.#.#
#.#.#.#.#.#.#.#.#........................#.#.#.#.#
#.#.#.#.#.#.#.#.#.####################.#.#.#.#.#.#
#.#.#.#.#.#.#.#.#.#......................#.#.#.#.#
#.#.#.#.#.#.#.#.#.#.##################.#.#.#.#.#.#
#.#.#.#.#.#.#.#.#.#.#................#.#.#.#.#.#.#
#.#.#.#.#.#.#.#.#.#.#.############.#.#.#.#.#.#.#.#
#.#.#.#.#.#.#.#.#.#.#.#............#.#.#.#.#.#.#.#
#.#.#.#.#.#.#.#.#.#.#.#.#########.#.#.#.#.#.#.#.#
#.#.#.#.#.#.#.#.#.#.#.#.#.......#.#.#.#.#.#.#.#.#
#.#.#.#.#.#.#.#.#.#.#.#.#.###.#.#.#.#.#.#.#.#.#.#
#.#.#.#.#.#.#.#.#.#.#.#.#.#.#.#.#.#.#.#.#.#.#.#.#
#.#.#.#.#.#.#.#.#.#.#.#.#.#.#.#.#.#.#.#.#.#.#.#.#
#.#.#.#.#.#.#.#.#.#.#.#.#.#.#.#.#.#.#.#.#.#.#.#.#
#.#.#.#.#.#.#.#.#.#.#.#.#.#.#.#.#.#.#.#.#.#.#.#.#
#.#.#.#.#.#.#.#.#.#.#.#.#.#.#.#.#.#.#.#.#.#.#.#.#
#.#.#.#.#.#.#.#.#.#.#.#.#.#.#.#.#.#.#.#.#.#.#.#.#
#.#.#.#.#.#.#.#.#.#.#.#.#.#.#.#.#.#.#.#.#.#.#.#.#
#.#.#.#.#.#.#.#.#.#.#.#.#.#.#.#.#.#.#.#.#.#.#.#.#
#.#.#.#.#.#.#.#.#.#.#.#.#.#.#.#.#.#.#.#.#.#.#.#.#
#.#.#.#.#.#.#.#.#.#.#.#.#.#.#.#.#.#.#.#.#.#.#.#.#
#.#.#.#.#.#.#.#.#.#.#.#.#.#.#.#.#.#.#.#.#.#.#.#.#
#.#.#.#.#.#.#.#.#.#.#.#.#.#.#.#.#.#.#.#.#.#.#.#.#
#.#.#.#.#.#.#.#.#.#.#.#.#.#.#.#.#.#.#.#.#.#.#.#.#
#.#.#.#.#.#.#.#.#.#.#.#.#.#.#.#.#.#.#.#.#.#.#.#.#
#.#.#.#.#.#.#.#.#.#.#.#.#.#.#.#.#.#.#.#.#.#.#.#.#
#.#.#.#.#.#.#.#.#.#.#.#.#.#.#.#.#.#.#.#.#.#.#.#.#
#.#.#.#.#.#.#.#.#.#.#.#.#.#.#.#.#.#.#.#.#.#.#.#.#
#.#.#.#.#.#.#.#.#.#.#.#.#.#.#.#.#.#.#.#.#.#.#.#.#
#.#.#.#.#.#.#.#.#.#.#.#.#.#.#.#.#.#.#.#.#.#.#.#.#
#.#.#.#.#.#.#.#.#.#.#.#.#.#.#.#.#.#.#.#.#.#.#.#.#
#.#.#.#.#.#.#.#.#.#.#.#.#.#.#.#.#.#.#.#.#.#.#.#.#
#.#.#.#.#.#.#.#.#.#.#.#.#.#.#.#.#.#.#.#.#.#.#.#.#
#.#.#.#.#.#.#.#.#.#.#.#.#.#.#.#.#.#.#.#.#.#.#.#.#
#.#.#.#.#.#.#.#.#.#.#.#.#.#.#.#.#.#.#.#.#.#.#.#.#
#.#.#.#.#.#.#.#.#.#.#.#.#.#.#.#.#.#.#.#.#.#.#.#.#
#..............................................G#
##################################################