########
#S..#..#
#.#.#..#
#.#.##.#
#....#.#
#.##...#
#...#G.#
########
